################################################
#..............................................#
#.############################################.#
#.############################################.#
#.############################################.#
#.############################################.#
#.############################################.#
#.############################################.#
#.############################################.#
#.############################################.#
#.############################################.#
#.############################################.#
#.############################################.#
#.############################################.#
#.############################################.#
#.############################################.#
#.############################################.#
#.############################################.#
#.############################################.#
#.############################################.#
#.############################################.#
#.############################################.#
#./###########################################.#
#..............................................#
################################################
